path_width, tree_width, join_sum, max_length, min_length, length_diff, results_fast_join_600, results_nauty_600, results_pd_600
18, 9, 9, 12, 9, 3, 490, 490, 490
17, 14, 14, 20, 18, 2, 83060, 83060, 83060
15, 17, 17, 38, 26, 12, 4620124982141, 4620124982141, 4620124982141
14, 15, 15, 36, 24, 12, 651799780566, 651799780566, 651799780566
19, 17, 17, 25, 21, 4, 12147101, 12147101, 12147101
16, 10, 10, 22, 20, 2, 298472, 298472, 298472
10, 7, 7, 19, 17, 2, 7967, 7967, 7967
19, 23, 23, 84, 34, 50, -1, -1, -1
20, 25, 44, 72, 36, 36, -1, -1, -1
16, 11, 17, 17, 15, 2, 19656, 19656, 19656
15, 17, 33, 52, 26, 26, -1, -1, 468529964612645689
25, 19, 35, 17, 11, 6, 62051, 62051, 62051
16, 19, 34, 56, 28, 28, -1, -1, 17573826278174905210
19, 23, 45, 44, 34, 10, -1, 758993312327426, -1
18, 22, 40, 64, 32, 32, -1, -1, -1
20, 25, 42, 46, 36, 10, -1, 3815189416887244, -1
17, 20, 36, 74, 30, 44, -1, -1, -1
15, 17, 30, 64, 26, 38, -1, -1, 6931727268594526294
21, 18, 35, 24, 20, 4, 2353205, 2353205, 2353205
18, 22, 44, 42, 32, 10, -1, 108628064284770, 108628064284770
17, 6, 11, 7, 6, 1, 171, 171, 171
19, 18, 22, 8, 4, 4, 678908, 678908, 678908
19, 18, 22, 11, 7, 4, 6153037, 6153037, 6153037
5, 5, 8, 5, 4, 1, 42, 42, 42
19, 18, 22, 9, 6, 3, 205071, 205071, 205071
16, 11, 20, 50, 4, 46, 12928822063272637836, -1, 12928822063272637836
15, 11, 20, 45, 5, 40, 5062627458285356103, -1, 5062627458285356103
13, 12, 16, 18, 7, 11, 68318405910094, 68318405910094, 68318405910094
13, 12, 16, 14, 7, 7, 3950832414, 3950832414, 3950832414
18, 15, 14, 60, 4, 56, -1, -1, 7307683681072816695
19, 18, 22, 14, 7, 7, 65558639661, 65558639661, 65558639661
16, 15, 19, 14, 7, 7, 11808890597, 11808890597, 11808890597
21, 14, 20, 11, 5, 6, 1431719963, 1431719963, 1431719963
14, 14, 17, 20, 8, 12, -1, 19795884038245939, 19795884038245939
25, 17, 26, 13, 3, 10, -1, 8798574553789, -1
18, 17, 21, 10, 5, 5, 147774159, 147774159, 147774159
18, 17, 21, 12, 8, 4, 27118434, 27118434, 27118434
19, 18, 22, 15, 6, 9, 20439693959096, 20439693959096, 20439693959096
16, 12, 14, 65, 5, 60, 10818355338846766558, -1, 10818355338846766558
15, 15, 18, 15, 6, 9, 1642060329166, 1642060329166, 1642060329166
23, 15, 26, 11, 4, 7, 12863057340, 12863057340, 12863057340
15, 14, 18, 14, 9, 5, 2787650802, 2787650802, 2787650802
17, 16, 7, 10, 5, 5, 103383038, 103383038, 103383038
16, 15, 18, 15, 6, 9, 4616724831747, 4616724831747, 4616724831747
19, 18, 22, 18, 7, 11, -1, 7866816180528886, -1
17, 12, 15, 11, 7, 4, 633624, 633624, 633624
28, 12, 22, 11, 5, 6, 279119388, 279119388, 279119388
20, 16, 20, 12, 9, 3, 8896068, 8896068, 8896068
18, 14, 18, 12, 9, 3, 8539806, 8539806, 8539806
12, 6, 12, 6, 5, 1, 355, 355, 355
20, 17, 21, 7, 5, 2, 13366, 13366, 13366
21, 11, 15, 13, 5, 8, 8408133608, 8408133608, 8408133608
21, 11, 18, 56, 5, 51, 11270870952655688571, -1, -1
18, 10, 19, 16, 5, 11, 203990662970, 203990662970, 203990662970
19, 12, 17, 48, 3, 45, 5375331793447024653, -1, -1
19, 10, 14, 16, 8, 8, 28009336128, 28009336128, 28009336128
20, 11, 15, 20, 8, 12, 1688771063645301, 1688771063645301, 1688771063645301
26, 18, 22, 13, 5, 8, -1, 1230176492322, 1230176492322
25, 16, 20, 13, 5, 8, 379641333914, 379641333914, 379641333914
24, 16, 19, 14, 9, 5, 4188094581, 4188094581, 4188094581
28, 15, 19, 12, 9, 3, 14663696, 14663696, 14663696
21, 13, 17, 13, 5, 8, 48761607715, 48761607715, 48761607715
22, 11, 22, 60, 4, 56, 5319958482109009428, -1, -1
24, 14, 18, 13, 5, 8, 105638727704, 105638727704, 105638727704
22, 10, 18, 18, 5, 13, 58174187841139, 58174187841139, -1
24, 18, 27, 17, 3, 14, -1, -1, -1
20, 14, 17, 16, 8, 8, 1039209125269, 1039209125269, 1039209125269
34, 18, 34, 12, 6, 6, 25911253608, 25911253608, 25911253608
20, 14, 17, 20, 8, 12, 21541196949978321, 21541196949978321, 21541196949978321
20, 11, 15, 16, 8, 8, 184074384715, 184074384715, 184074384715
23, 18, 8, 13, 5, 8, 658432517040, 658432517040, 658432517040
26, 17, 20, 68, 4, 64, -1, -1, -1
23, 16, 13, 68, 4, 64, -1, -1, -1
19, 14, 17, 14, 9, 5, 1776085537, 1776085537, 1776085537
24, 17, 21, 20, 8, 12, -1, 847926881295242887, -1
18, 18, 0, 4, 2, 2, 4307, 4307, 4307
17, 16, 0, 5, 2, 3, 33334, 33334, 33334
18, 18, 0, 5, 2, 3, 60167, 60167, 60167
13, 12, 0, 4, 2, 2, 1010, 1010, 1010
18, 18, 0, 3, 2, 1, 287, 287, 287
13, 12, 0, 3, 2, 1, 119, 119, 119
15, 15, 0, 16, 2, 14, 205725692522, 205725692522, 205725692522
20, 19, 0, 3, 2, 1, 322, 322, 322
20, 19, 0, 5, 2, 3, 77154, 77154, 77154
18, 18, 0, 19, 2, 17, -1, 860219848242407, -1
49, 5, 10, 61, 58, 3, 1022, 1022, 1022
337, 30, 56, 16, 10, 6, -1, 542333044, -1
263, 31, 57, 18, 11, 7, -1, 26787484394, -1
199, 85, 165, 16, 9, 7, -1, -1, -1
97, 23, 42, 13, 7, 6, 571686230, 571686230, 571686230
19, 7, 14, 8, 6, 2, 28, 28, 28
36, 13, 24, 12, 6, 6, 2498, 2498, 2498
23, 7, 13, 8, 5, 3, 42, 42, 42
30, 10, 19, 9, 6, 3, 144, 144, 144
29, 9, 16, 9, 7, 2, 58, 58, 58
29, 10, 20, 11, 8, 3, 89, 89, 89
45, 14, 23, 17, 7, 10, 110021, 110021, 110021
47, 13, 25, 12, 8, 4, 598, 598, 598
40, 13, 26, 17, 8, 9, 71430, 71430, 71430
41, 14, 26, 15, 6, 9, 45728, 45728, 45728
